8
18
K_M_#_X__^***=====
W__^_=@**____=====
*#X_T_____XXXX__=_
__________^_______
******************
_____^____________
__===#===#^*!!____
******************